#####------#####
###--##--##--###
##-###----###-##
#--------------#
#--------------#
-#----####----#-
-##--######--##-
-##--######--##-
-#---######--##-
------####------
----------------
#---##-##-##---#
##-###-##-###-##
##-##########-##
###-########-###
####--------####
